13,1,1,5,1,31,1,0,1,1,6,1,1,5,1
1,0,0,1,0,0,35,0,1,0,0,0,32,0,1
1,1,0,1,7,1,0,1,3,1,1,1,0,33,1
0,2,1,0,0,1,1,1,0,0,0,1,0,0,14
12,0,1,1,1,1,0,34,1,0,5,1,0,37,1
1,0,1,0,0,5,1,0,1,0,1,1,1,0,0
6,0,5,1,1,1,0,0,4,0,1,0,1,1,7
1,0,1,0,1,0,0,1,1,1,1,0,0,1,1
8,21,1,1,1,1,0,1,0,0,1,1,5,0,1
1,0,1,0,0,1,8,1,0,1,6,0,1,0,4
26,0,4,1,1,0,0,1,0,1,0,11,1,0,1
0,1,1,0,0,1,4,1,1,5,1,0,1,1,1
28,0,1,1,0,1,0,0,1,0,1,3,1,0,1
3,1,0,1,1,1,1,0,1,0,1,0,1,0,16
0,18,1,1,0,0,34,1,1,1,7,1,5,0,36
