2,1,1,4,1,6,1,5,1,7
0,0,0,0,0,0,0,0,0,1
1,21,1,19,1,17,1,7,1,8
23,0,0,0,0,0,0,0,0,0
1,10,1,12,1,14,1,16,1,29
0,0,0,0,0,0,0,0,0,1
1,34,1,33,1,28,1,26,1,30
36,0,0,0,0,0,0,0,0,0
1,1,16,0,11,1,13,0,3,37
35,0,1,9,1,0,1,15,25,0
